#;#;#;#;#;#;#;#;#;#;#;#;#;#;#;#;#;#;#;#;#;#;#;#;#;#;#;#;#;#;#;#;#;#;#;#;#;#;#;#;#;#;#;#;#;#;#;#;#;#
#;.;.;.;.;.;.;.;#;.;.;.;.;.;.;.;.;.;.;.;.;.;.;.;.;.;.;.;.;.;.;.;.;#;.;.;.;.;.;.;.;.;.;.;.;.;.;.;.;#
#;.;.;.;.;.;.;.;#;.;.;.;.;.;.;.;.;.;.;.;.;.;.;.;.;.;.;.;.;.;.;.;.;#;.;.;.;.;.;.;.;.;.;.;.;.;.;.;.;#
#;.;.;.;.;.;.;.;#;.;.;.;.;.;.;.;.;.;.;.;.;.;.;.;.;#;#;#;#;#;#;#;#;#;.;.;.;.;.;.;.;.;.;.;.;.;.;.;.;#
#;.;.;.;.;.;.;.;#;.;.;.;.;.;.;.;.;.;.;.;.;.;.;.;.;.;.;.;.;.;.;.;.;#;.;.;.;.;.;.;.;.;.;.;.;.;.;.;.;#
#;.;.;AB;.;.;.;.;#;.;.;.;.;.;.;.;.;.;.;.;.;.;.;.;.;.;.;.;.;.;.;.;.;#;.;.;.;.;.;.;.;.;.;.;.;.;.;.;.;#
#;.;.;.;.;.;.;.;#;B;.;.;.;.;.;.;.;.;.;.;.;.;.;.;.;.;.;.;.;.;.;.;.;#;#;#;#;#;#;#;#;.;.;.;.;.;.;.;.;#
#;.;.;.;.;.;.;.;#;.;.;.;.;.;.;.;.;.;.;.;.;.;.;.;.;.;.;.;.;.;.;.;.;#;.;.;.;.;.;.;.;.;.;.;.;.;.;.;.;#
#;.;.;.;.;.;.;.;#;.;.;.;.;.;.;.;.;.;.;.;.;.;.;.;.;.;.;.;.;.;.;.;.;#;.;.;.;.;.;.;.;.;.;.;.;.;.;.;.;#
#;.;.;.;.;.;.;.;.;.;.;.;.;.;.;.;.;.;.;.;RB;.;.;.;.;.;.;.;.;.;.;.;.;#;.;.;.;.;.;.;.;.;.;.;.;.;.;.;.;#
#;#;#;#;.;.;.;.;.;.;.;.;.;.;.;.;.;.;.;.;.;.;.;.;.;.;.;.;.;.;.;.;.;#;.;.;.;.;.;.;.;.;.;.;.;.;.;.;.;#
#;.;.;.;.;.;.;.;.;.;.;.;.;.;.;.;.;.;.;.;.;.;.;.;.;.;.;.;.;.;.;.;.;.;.;.;.;.;.;.;.;.;.;.;RB;.;.;.;.;#
#;.;.;.;.;.;.;.;.;.;.;.;.;.;.;.;.;.;.;.;.;.;.;.;.;.;.;.;.;.;.;.;.;.;.;.;.;.;.;.;.;.;.;.;.;.;.;.;.;#
#;.;.;.;.;.;.;.;.;.;.;.;.;.;.;.;.;.;.;.;.;.;.;.;.;.;.;.;.;.;.;.;.;.;.;.;.;.;.;.;.;.;.;.;.;.;.;.;.;#
#;.;.;.;.;.;.;.;.;.;.;.;.;.;.;.;.;.;.;.;.;.;.;.;.;.;.;.;.;.;.;.;.;RB;.;.;.;.;.;.;.;.;.;.;.;.;.;.;.;#
#;.;.;.;.;.;.;.;.;.;.;.;.;.;.;.;.;.;.;.;.;.;.;.;.;.;.;.;.;.;.;.;.;.;.;.;.;.;.;.;.;.;.;.;.;.;.;.;.;#
#;.;.;.;.;.;.;.;.;.;.;.;.;.;.;.;.;.;.;#;#;#;#;.;.;.;.;.;.;.;.;.;.;.;.;.;.;.;.;.;.;.;.;.;.;.;.;.;.;#
#;.;.;.;.;.;.;.;.;.;.;.;.;.;.;.;.;.;.;#;#;#;#;.;.;.;.;.;.;.;.;.;.;.;.;.;.;.;.;.;.;.;.;.;.;.;.;.;.;#
#;.;.;.;.;.;.;.;.;.;.;.;.;.;.;.;.;.;.;#;#;#;#;.;.;.;.;.;.;.;.;.;.;.;.;.;.;.;.;.;.;.;.;.;.;.;.;.;.;#
#;.;.;.;.;#;#;#;#;.;.;.;.;.;.;.;.;.;.;#;#;#;#;.;.;.;.;.;.;.;.;.;.;.;.;.;.;.;.;.;.;.;.;.;.;.;.;.;.;#
#;.;.;.;.;#;#;#;#;.;.;.;.;.;.;.;.;.;.;.;.;.;.;.;.;.;.;.;F;.;.;.;.;.;.;.;.;.;.;.;.;.;.;.;.;.;.;.;.;#
#;.;.;.;.;#;#;#;#;.;.;.;.;.;.;.;.;.;.;.;.;.;.;.;.;.;.;.;.;.;.;.;.;.;.;.;.;.;.;.;.;.;.;.;.;.;.;.;.;#
#;.;.;.;.;#;#;#;#;.;.;.;.;.;.;.;.;.;.;.;.;.;.;.;.;.;.;.;.;.;.;.;.;.;.;.;.;.;.;#;#;.;.;.;.;.;.;.;.;#
#;.;.;.;.;.;.;.;.;.;.;.;.;.;.;.;.;.;.;.;.;.;.;.;.;.;.;.;.;.;.;.;.;.;.;.;.;.;.;#;#;.;.;.;.;.;.;.;.;#
#;.;.;.;.;.;.;.;.;.;.;.;.;.;.;.;.;.;.;.;.;.;.;.;.;.;.;.;.;.;.;.;.;.;.;.;.;.;.;.;.;.;.;.;.;.;.;.;.;#
#;.;.;.;.;.;.;.;.;.;.;.;.;.;.;.;.;.;.;.;.;.;.;.;.;.;.;.;.;.;.;.;.;.;.;.;.;.;.;.;.;.;.;.;.;.;.;.;.;#
#;.;.;.;.;.;.;.;.;.;.;.;.;.;.;.;.;.;.;.;.;.;.;.;.;.;.;.;.;.;.;.;.;.;.;.;.;.;.;.;.;.;.;.;.;.;.;.;.;#
#;.;.;.;.;.;.;.;.;.;.;.;.;.;.;.;.;.;.;.;.;.;.;.;.;.;.;.;.;.;.;.;.;.;.;.;.;.;.;.;.;.;.;.;.;.;.;.;.;#
#;.;.;.;.;.;.;.;.;.;.;.;.;.;.;.;RB;.;.;.;.;.;.;.;.;.;.;.;.;.;.;.;.;.;.;.;.;.;.;.;.;.;.;.;.;.;.;.;.;#
#;#;#;#;#;#;#;#;#;#;#;#;#;#;#;#;#;#;#;#;#;#;#;#;#;#;#;#;#;#;#;#;#;#;#;#;#;#;#;#;#;#;#;#;#;#;#;#;#;#
